{
  "name": "Level 2",
  "ghostSpeed": 2.0,
  "pacmanSpeed": 2,
  "frightenedDuration": 5000,
  "tiles": [
    [1,1,1,1,1,1,1,1,1,1,1,1,1,1,1,1,1,1,1,1,1,1,1,1,1,1,1,1],
    [1,2,2,2,2,2,2,2,2,2,2,2,2,1,1,2,2,2,2,2,2,2,2,2,2,2,2,1],
    [1,2,1,1,1,1,2,1,1,1,1,1,2,1,1,2,1,1,1,1,1,2,1,1,1,1,2,1],
    [1,3,1,0,0,1,2,1,0,0,0,1,2,1,1,2,1,0,0,0,1,2,1,0,0,1,3,1],
    [1,2,1,1,1,1,2,1,1,1,1,1,2,1,1,2,1,1,1,1,1,2,1,1,1,1,2,1],
    [1,2,2,2,2,2,2,2,2,2,2,2,2,2,2,2,2,2,2,2,2,2,2,2,2,2,2,1],
    [1,2,1,1,2,1,2,1,1,2,1,1,1,1,1,1,1,1,2,1,1,2,1,2,1,1,2,1],
    [1,2,1,1,2,1,2,1,1,2,1,1,1,1,1,1,1,1,2,1,1,2,1,2,1,1,2,1],
    [1,2,2,2,2,2,2,1,1,2,2,2,2,1,1,2,2,2,2,1,1,2,2,2,2,2,2,1],
    [1,1,1,1,2,1,2,1,1,1,1,1,0,1,1,0,1,1,1,1,1,2,1,2,1,1,1,1],
    [1,1,1,1,2,1,2,1,1,1,1,1,0,1,1,0,1,1,1,1,1,2,1,2,1,1,1,1],
    [1,1,1,1,2,1,2,1,1,0,0,0,0,0,0,0,0,0,0,1,1,2,1,2,1,1,1,1],
    [1,1,1,1,2,1,2,1,1,0,1,1,1,0,0,1,1,1,0,1,1,2,1,2,1,1,1,1],
    [1,1,1,1,2,1,2,1,1,0,1,0,0,5,5,0,0,1,0,1,1,2,1,2,1,1,1,1],
    [0,0,0,0,2,0,2,0,0,0,1,0,5,5,5,5,0,1,0,0,0,2,0,2,0,0,0,0],
    [1,1,1,1,2,1,2,1,1,0,1,0,0,0,0,0,0,1,0,1,1,2,1,2,1,1,1,1],
    [1,1,1,1,2,1,2,1,1,0,1,1,1,1,1,1,1,1,0,1,1,2,1,2,1,1,1,1],
    [1,1,1,1,2,1,2,1,1,0,0,0,0,0,0,0,0,0,0,1,1,2,1,2,1,1,1,1],
    [1,1,1,1,2,1,2,1,1,0,1,1,1,1,1,1,1,1,0,1,1,2,1,2,1,1,1,1],
    [1,1,1,1,2,1,2,1,1,0,1,1,1,1,1,1,1,1,0,1,1,2,1,2,1,1,1,1],
    [1,2,2,2,2,2,2,2,2,2,2,2,2,1,1,2,2,2,2,2,2,2,2,2,2,2,2,1],
    [1,2,1,1,2,1,2,1,1,1,1,1,2,1,1,2,1,1,1,1,1,2,1,2,1,1,2,1],
    [1,2,1,1,2,1,2,1,1,1,1,1,2,1,1,2,1,1,1,1,1,2,1,2,1,1,2,1],
    [1,3,2,2,2,2,2,2,2,2,2,2,2,4,0,2,2,2,2,2,2,2,2,2,2,2,3,1],
    [1,1,1,2,1,1,2,1,1,2,1,1,1,1,1,1,1,1,2,1,1,2,1,1,2,1,1,1],
    [1,1,1,2,1,1,2,1,1,2,1,1,1,1,1,1,1,1,2,1,1,2,1,1,2,1,1,1],
    [1,2,2,2,2,2,2,1,1,2,2,2,2,1,1,2,2,2,2,1,1,2,2,2,2,2,2,1],
    [1,2,1,1,1,1,1,1,1,1,1,1,2,1,1,2,1,1,1,1,1,1,1,1,1,1,2,1],
    [1,2,1,1,1,1,1,1,1,1,1,1,2,1,1,2,1,1,1,1,1,1,1,1,1,1,2,1],
    [1,2,2,2,2,2,2,2,2,2,2,2,2,2,2,2,2,2,2,2,2,2,2,2,2,2,2,1],
    [1,1,1,1,1,1,1,1,1,1,1,1,1,1,1,1,1,1,1,1,1,1,1,1,1,1,1,1]
  ]
}
